Cupid - Twin Ver. - FIFTY FIFTY
Flowers - Miley Cyrus
Kill Bill - SZA
Daylight - David Kushner
TQG - KAROL G
As It Was - Harry Styles
Classy 101 - Feid
PRC - Peso Pluma
Calm Down (with Selena Gomez) - Rema
BESO - ROSAL√çA
Die For You (with Ariana Grande) - Remix - The Weeknd
Creepin' (with The Weeknd & 21 Savage) - Metro Boomin
El Azul - Junior H
Yandel 150 - Yandel
AMG - Natanael Cano
See You Again (feat. Kali Uchis) - Tyler, The Creator
Boy's a liar Pt. 2 - PinkPantheress
Anti-Hero - Taylor Swift
Last Night - Morgan Wallen
Die For You - The Weeknd
I'm Good (Blue) - David Guetta
Por las Noches - Peso Pluma
I Wanna Be Yours - Arctic Monkeys
El Gordo Trae El Mando - Chino Pacas
Here With Me - d4vd
Shakira: Bzrp Music Sessions, Vol. 53 - Bizarrap
Unholy (feat. Kim Petras) - Sam Smith
Like Crazy - Jimin
golden hour - JVKE
Until I Found You (with Em Beihold) - Em Beihold Version - Stephen Sanchez
Starboy - The Weeknd
Eyes Closed - Ed Sheeran
I Ain't Worried - OneRepublic
FLOWER - JISOO
Another Love - Tom Odell
Hey Mor - Ozuna
La Bachata - Manuel Turizo
Moonlight - Kali Uchis
Angels Like You - Miley Cyrus
People - Libianca
Quevedo: Bzrp Music Sessions, Vol. 52 - Bizarrap
Mockingbird - Eminem
Cruel Summer - Taylor Swift
Coco Chanel - Eladio Carrion
Chemical - Post Malone
Chanel - Becky G
OMG - NewJeans